BBBBBBBBBBBBBBBBBBBBBBBBBBBBBBBBBBBBBBBBBBBBB
BMEEEREEEREEEE*EEREEEEEEEEEEEEE*EEEEREEEREEEB
BEEEEREERREEEREE*EEEREEEEERRREERRREEEEE*ERERB
BEEEEREEEEEEEEEEEEEEE*EERE*EEEERREEREREREEEEB
BEEEEEE*EEREEEEEREEEREEEEE*E*EEEEEEEERE*EEEEB
BEEEEEEEEEEEEREEEEEEEEERREEEEEREEEEER*EREEERB
BEEEEEEEEEEEEEEEEEEEEEEREEEEEEE*REE*EEEEEEREB
BBBBBBBBBBBEEEEEBBBBBBBBBEEEEEEEEEEEEEEERREEB
BEER*EERREREEEEE**EEEEEE**EER*EEEEEEEEEEEEEEB
BEEEEEEE**EREEEERREREERRREEEEEE*EE*E*EEEEEEEB
BEER*EEEEEEREEEEEERER*EEEEERREEEEEEEEEE*EEEEB
BERREEERRREEEERRREREEEREEEREEER*EEEEEEEEEEEEB
BEEE**EEEEEEEEEEEEEEEEEEEEEEEEEEEEEEEEEEEEEEB
BEEEERRREREE**EE*EERREERREERREEE*REEEEEEEEEEB
BEE*EEE*E*EEEERREEEEEEEEEEEEEEEEEEEEEEEEEEEEB
BEEEEREEEREEEEEEEEEEEEEEEEEEEEEEEEEEEEEEEEEEB
BBBBBBBBBBBBBBBBBBBBBBBBBBBBBBBBBBBBEEEEEEEEB
BEEEEEEREREREREREEEEEEEER*EE*EEEEEEE*ERRRREEB
BEEERREREEEEEREEREER*EEEERREEEEEEEEEEEER*EEEB
BEREE*EEEEE*EEEEEEREEE*EREEEEEER*EEEEEE*EEEEB
BRRREEEREEERREERREEREEEEEEEERRRRRREEERRREEEEB
BEEEEEREEEEEEEEERREEEEREEEEEEEEEEEREREREEEEEB
BERERERER**RRREEEEEEEEEEEEEEEEEEEEEEEEEEEDEEB
BEEERREEEEEEEREEEEEEEEEEER*EEEEEEEEEEEEEEEEEB
BBBBBBBBBBBBBBBBBBBBBBBBBBBBBBBBBBBBBBBBBBBBB