BBBBBBBBBBBBBBBBBBBBBBBBBBB
BEEMEEEEERREEEEREEEE*EEEEEB
BEE*EEEREEEEEEREEEEEREEE*EB
BEEEEEREE*EEEEEE*RERREEEEEB
BBBBBBBBBBBBBBBBBBEEEEER*EB
BEER*EEEEEERREEEE*EEEEEEEEB
BEEEEERRREEEEDEEEERR**EEEEB
BEEREEEEREREEEERREEEE*EEEEB
BEEEE*EEEEEREEEE*EEEEREEEEB
BBBBBBBBBBBBBBBBBBBBBBBBBBB