BBBBBBBBBBBBBBB
BMEEE*EEEEEREEB
BEEEE*EEEEEEEEB
BEEEE*EEEEEEEEB
BEEEE*EEEDEEEEB
BEEEE*EEEEEEEEB
BBBBBBBBBBBBBBB



	
	