BBBBBBBBBBBBBBBBBBBBBBBBBBBBBBBBBBBBBBBB
BMEEEEREREREREREREREEEEEEEEREREREREREREB
BEEREEEEEEEREREREEEERERERREREEEEEEEEEEEB
BEEEEREEEERRERERREEERERRRRRRRRRRRREREREB
BEEEE*EEREREEEREEEEREREEEEEEEEEEEEEEEREB
BEEEREREEEEREREREEEEEREREREEEEEEEEEREEEB
BEREREE*EEREEEEREEEEREREEEEEEREREREEEEEB
BEREREEEREERER*REEEEREREEEEE*EEEE*EE*EEB
BEEEEEEERREEEEEEEREEEEEEEEEREREEEEEEEEEB
BEERERE*REEE*EEREREERERREEEEE*EEEEEE*EEB
BEREEEEEEEREEEEEREREREEEEEE*EEEE*REEEREB
BEEEEREEREEEEEEREREEREEEEEEEEE*EREEEEEEB
BEEEEEEEREEEE*EERREERREREEEE*EEEEEE*EERB
BEREREREEEEEEEEEREEEEEEEEREREEEEE*EEEEEB
BEEEEEREERRREEEREREEREEEEEEEE*EERERER*EB
BEEREEEREEREE*EEEEREREEEEEEEREEEEEREEEEB
BERERREREEEEEEEREREERREEEEEEREEEEEREEEEB
BEEEREEEEEREEEEERREEREREEEEEEREEEREEREEB
BEEREREEREEEEEEEEEEERREEEEEEEEEEEEEEEEDB
BBBBBBBBBBBBBBBBBBBBBBBBBBBBBBBBBBBBBBBB
