BBBBBBBBBBBBBBBBBBBBBBBBBBBBBBBBBBBBBBBBBBBBB
BMEEEEEEEEEEEEEEEEEEEEEEEEEEEEEEEEEEEEEEEEEEB
BEEEEE*EEEEEEREEEEEREEEEEEREEEEEEREEEEEEEEEEB
BEEEEEEEEEREEREEEREEEREEEEREEEEEEEEEEEEEEEEEB
BEEEEEEEEEEEEEEEEEEEEEEEEEEEEEREEEEEEEEEEEEEB
BEEEEEEEEEEEEEEEEEEEEEEE*EEEEEEEEEEEEEEEEEEEB
BEEEEE*EEEEEEEEEEEEEEEEEEEEEEEEEEEEEEE*EEEEEB
BEEEEEEEREEEEEEEEEEE*EEEEEEEEEEEEEEEEEEEEEEEB
BEEEEEEEEEEEEEEEEEEEEEEEEEEEEEEEEEEEEEEEEEEEB
BEEEEEEEEEEEEEREEREEEEEEERREEREEEEEEEEE*EEEEB
BEEEEEEEEEEREEEEEEEEEEEEEEEEEEEEEEEEEEEEEEEEB
BEEEREEEEEEEEEEEEEEEEEEEEEEEEEEEEEEREEEEEEEEB
BEEEEEEEEEEEEEEES  EEEEEEEES  EEEEEEEEEEEEEEB
BEEEEEE*EEEEEEEE   EEEEEEEE   EEEEEEEEEEEEEEB
BEEEEEEEEEEEEEEEEEEEEEEEEEEEEEEEEEEEEEEEEEEEB
BEEEERREEEEEEEEEEEEEEEEEEEEEEEEEEEEEEEEEEEEEB
BEEEEEEEEEEEEEEERREEEEEEEEE*EEEEEEEEEEEEEEEEB
BEEEEEEE*EEEEEEEEREEEEEEEEEEEEEEEEEEEEEEEEEEB
BEEEEEEEEEEEEEEEEEEEEEEEEEEEEEEEEEEEEEEEEEEEB
BEEEEEEEEEE*EEEEEEEEEEEEEEEEEEEEEEEEEEEEEEEEB
BEEEEEEEEEEEEEEEEEEEEEREEEEEEEEEEE*EEEEEEEEEB
BEEEEEEEEEEEEEEEEEEEEEEEEEEEEEEEEEEEEEEEEEEEB
BEEEEE*RREEEEEEEEEEEEEE*EEEEEEEEEEEEEEEEEEDEB
BEEEEEEEEEEEEEEEEEEEEEEEEEEEEEEEEEEEEEEEEEEEB
BBBBBBBBBBBBBBBBBBBBBBBBBBBBBBBBBBBBBBBBBBBBB