BBBBBBBBBBBBBBBBBBBBBBBBBBBBBBBBBBBBBBBBBBBBBBBBBB
BMEEEEEEEEEEEEEEEEEEEEEEEEEEEEEEEEEEEEEEEEEEREEEEB
B EEEEEEEEEEEEEEEEEEEEEEEREEEEEEEEEEEEEEEEEEEEEEEB
B                ! EEEEEEEEREEEREEEEEEREEEEEEEEEEB
BEEEEEEEEEEEEEEEEEEEEEEEEEEEEEEEEREEEEEEEEREEEEEEB
BEEEEEEEEEREEREEREEEEEEEEEEEEEEEEEEEEEEEEEEEEREEEB
BEEEEEEEEEEEEEEEEEEEREEEEEEEEEEEEEEEEEEEEEEEEEEEEB
BERREREEEEEEEREEEEEEEEEEEEEEEEEEEEREEEEEEEERREEEEB
BE*RREEEEEEERREEEEEEEEEEEEEEEEEEEEEREEEEEEREEEREEB
BEEEEEEEEEEEEEEREEEEEEEEEEEEEEEEEEEEEEEEEEEEEEEEEB
BEREEEEEEEEEEEEEEEEEEEEEEEEEEEEEEEEEEEEEEEEEEEEEEB
BE*EEEEEEERRERREEEEEEEEEEEEEEEEEEEEEEEEEEEEEEEEEEB
BEEEEEEEEEEEEEEEEEEEEEEEEEEEEEEEEEEEEEEEEEEEEEEEEB
BEEEEE*EEEE*EEEEEEEEE*EEE*REEEE*EEEEE*EEEEEEEEEEEB
BBBBBBBBBBBEEEEEBBBBBBBBBBEEEEEEBBBBBBBBBBBBBBBBBB
BEEEEEEEERERREREEEEEEEEEERERERE*EEEEEEEEEREREREREB
BEEEEEREREEEEEEEEEEEEEEEEREREEEEEEEEEEEEEEEEREREEB
BEEEEEEE*EEEEEEEEEEEEEREREEEEEEEEEEEEEEEEE*EEEEEEB
BEEEEEEEEEEEEREEREER*EEEEEEEEEEEEEEEREEEEEEEEEEEEB
BEEEEEREREEEEEEEEEEEEEEEEEEREREEEEEEEEEEEEEEEEEEEB
BEEEEEEREEEEEEREREEEEEEEEEEEEEEEEEEEEEEEREEREEEEEB
BEEEEEEEEEEEEEEREEEEEEEREEEEEEEEEEEEEEEEEEE*EEEEEB
BEEEEEEREEE*EEEREEEREEEEEEEEEEEEEEEE*EEEEEEEEEEEEB
BEEEE*EEEREREREEEEERREEEEE*EEEEE*EEEEEEEEEEEEEEEEB
BEEEEEEEEEEEEEEEEEEEEEEEEEEEERREEE*EEEEEEEEREEE*EB
BEEEEEREE*S EEEEEEE*S EEREEE*S EEEEEEEEEEEEEEEEEEB
BEEEREEEE   EEEEEEE   EEEERE   EEEEEEREEEEEEEEEEEB
BEEEEEEREEEREEEEEEEEEEEEEEEEEEEEEEEEREEEEEEREEEEEB
BEEEEEEEEEEEEREEEREEEEEEEEEEEEEEEEEEEEEEEEEEEEEEEB
BEEEEEEEEEEEEEEEEEEEEEEEEEEEEEEEEEEEEEEEEEEEEEEEEB
BBBBBBBBBBBBBBBBBBBBEEEE*EEEEEBBBBBBBBBBBBBBBBBBBB
BEEEEEEEEEEEEEEEEEEEEEEEEEEEEEEEEEEEEEEEEEEEEEEEEB
BEEEEEEEEEEEEEEEEEEEEEEEEEEEEEEREEEEEEEEEEEEEEEEEB
B*!             EEEEEEEEEEEEEREEE              !*B
BEEEEEEEEEEEEEEEEEEEEEEEEEEEEEEREEEEEEEEEEEEEEEEEB
BEEEEEEEEEEEEEEEEEEEEEEEEEEEEEEEEEEEEEEEEEEEEEEEEB
BEEEREEEEEEEEEEREEEEEEEEEEEEEEEEEEEEEEEEEEEEEEEEEB
BEEEEEEEEREEEEEEEREREEEEEEEEEEEEEREEEEEEEEEEEEEEEB
BEEEEEEEEEEEEEEEEREEEEEEREEEEEEEEEEEEEEEEEEEEEEEEB
BEEEEREEE*EEEEEEEEEEEEEEEEEEEEEEEEEEEEEEEEEEEEEEEB
BEEREEEEEEE*EEEEEEEEEEEEEEEEEREEEEEEEEEEEEEEEEEEEB
BEEREEEE*EEEEEEEEEEEEEEEEEEEEEEEEEEEEEEEEEEEEEEEEB
BEEEEEEE*EEEEEEEEEEEEEEEEEEEEEEEREEEEEEEEEEEEEEEEB
BEEEREE*EEEEEEEEEEEEEEEE*EEEEEREEEEEREEEEEEEEEEEEB
BEEEEEEEEEEEEEEEEE*EEEEEEEEEEEEEEEEEEEEEEREEEEEEEB
BEEEEEEEEEEEEEEEEEEEEEEEEEEEEEEEEEEEEEEEEEEREEEEEB
BEEEEE*EEEEEEEEEEE*EEEEEEEEEEEEEEEEEEEEEEEEEEEEEEB
BEEEEEEEEEEEEEEEEEEEEEEEEEEEEE*EEEEEEE*EEEEEEEEEEB
BEEEEEEEEEEEEEEEEEEEEEEEEEEEEEEEEEEEEEEEEEEEEEEEEB
BBBBBBBBBBBBBBBBBBBBBBBBBBBBBBBBBBBBBBBBBBBBBBBBBB