BBBBBBBBBBBBBBBBBBBBBBBBBBBBBBBBBBBBBBBBBBBBBBBBBB
BMEEEEEEEEEEEEEEEEEEEEEEEEEEEEEEEEEEEEEEEEEEEREEEB
BEEREEEEEEREEEEEEEEEEEEEEEEEEEEEEEEREEEREEEREEEEEB
BEEEEEREEREEEEEREEEEEEEREEEEEEEEEEEEEEEEREEREEEEEB
BEEEEEEEEEEEEEEEEEEEEEEEEEEEEEEEEREEEEEEEEREEEEEEB
BEEEEEEEEEEEE*EE*EEEEEEEEEEEEEEEEEEEEEEEEEEEEREEEB
BBBBBBBBBEEEEEEEEEEE*EEEEEEEEEEEEEEEEEEEEBBBBBBBBB
BERREEEEBEEEEEEEEEEEEEEEEEEEEEEEEE*EEEEEEBERREEEEB
BEEREEEEBEEEEEEEEEEEEEEEEEEEEEEEEEE*EEEEEBREEEREEB
BEEEEEEEEEEEEEE*EEEEEEEEEEEE*EEEEEEEEEEEEEEEEEEEEB
BEEEEEEEEEEEEEEEEEEEEEEEEEEEEEEEEEEEEEEEEEEEEEEEEB
BEES  EEBEEEEEEEEEEEEEEEEEEEEEEEEEEEEEEEEBES  EEEB
BEE   EEBEEEEEEEEEEEEEEEEEEEEEEEEEEEEEEEEBE   EEEB
BBBBBBBBBEEEEEEEEEEEE*EEEEEEEEEEEEEEEEEEEBBBBBBBBB
BEREREREEEEEEEEEEEEREREREEEEEEEEEEEEEEEEEEEEEERERB
BEEEEEEEERERREREEEEEEEEEERERERE*EEEEEEEEEREREREREB
BEEEEEREREEEEEEEEEEEEEEEEREREEEEEEEEEEEEEEEEREREEB
BEEEEEEE*EEEEEEEEEEEEEREREEEEEEEEEEEEEEEEE*EEEEEEB
BEEEEEEEEEEEEREEREER*EEEEEEEEEEEEEEEREEEEEEEEEEEEB
BEEEEEREREEEEEEEEEEEEEEEEEEREREEEEEEEEEEEEEEEEEEEB
BEEEEEEREEEEEEREREEEEEEEEEEEEEEEEEEEEEEEREEREEEEEB
BEEEEEEEEEEEEEEREEEEEEEREEEEEEEEEEEEEEEEEEE*EEEEEB
BEEEEEEREEE*EEEREEEEEEEEEEEEEEEEEEEE*EEEEEEEEEEEEB
BEEEE*EEEREREREEEEEEEEE     EEEE*EEEEEEEEEEEEEEEEB
BEEEEEEEREEEEEEEEEEEEEE  !  REEEE*EEEEEEEEREEE*EEB
BEEEEEREEEEEEEEEEEEEERE  *  EEEEEEEEEEEEEEEEEEEEEB
BEEEREE*EEE*EEERREEEEEEEEEREEEREEEEEEREEEEEEEEEEEB
BEEEEEEREEEREEEEEEEEEEEEEEEEEEEEEEEEREEEEEEREEEEEB
BEEEEEEEEEEEEREEEEEEEEEEEEEEEEEEEEEEEEEEEEEEEEEEEB
BBBBBBBBBBBBBBBBBBBBBBBBBBBBBBBBBBBBBBBBBBBBBBBBBB
